# # # # # # # # # # P # J # # 
# - - - - - - - - - - - - - #
# - - - # - - # - - - - - - # 
# - # - - - - - - - - - - - # 
# - # - - # - - - - - - - - # 
# - # - - - - - # # - - - # # 
# - - - # - - - - - - # - # # 
# - # - - - # - - - - - - - # 
# - - - - - - - - - - # # - # 
# - - - - # - - - - # - - # # 
# - - - - - - - # - - - - - # 
# - - - # # - - - - - - - - # 
# - - - - - # - - - - - - - # 
# - - - - - - - - - - - - - #
# # F # # # # # # # # # # # # 
